16 13 03 12 04 14 03 13 04 12 03 14 04 13 03 12 17
23 30 19 30 19 30 19 30 19 30 19 30 19 19 19 05 20
22 19 19 19 19 19 19 19 19 19 19 19 19 19 19 19 27
23 19 19 19 19 19 19 19 19 19 19 19 19 19 19 05 20
22 19 19 30 19 19 30 19 30 19 30 19 30 19 30 19 27
23 19 46 31 32 31 32 31 32 31 32 31 32 31 32 31 20
22 19 19 19 19 19 19 19 19 19 19 19 19 19 19 19 27
23 19 19 19 19 19 19 19 37 19 19 19 19 19 19 19 20
22 29 32 29 32 29 32 29 32 29 32 29 32 19 19 45 27
23 30 19 30 19 30 19 30 19 30 19 30 19 19 19 44 20
22 19 19 19 19 19 19 19 19 19 19 19 19 19 19 19 27
23 19 30 19 30 19 30 19 30 19 30 19 30 19 19 38 20
22 19 29 32 33 32 33 32 33 32 33 32 33 32 33 32 27
23 19 30 46 19 19 19 19 19 19 19 19 19 19 19 19 20
22 19 30 19 19 19 29 31 31 31 31 31 31 31 31 19 27
23 19 30 19 19 19 30 19 19 19 19 19 19 19 19 19 20
22 19 19 19 19 05 30 19 19 19 19 19 19 19 19 19 27
16 13 14 12 13 14 12 13 14 12 13 14 12 13 14 12 17