16 13 14 12 13 14 12 13 14 12 13 14 12 13 14 12 17
23 19 19 19 19 19 19 19 19 19 19 19 19 19 19 19 20
22 19 19 19 19 19 19 19 19 19 19 19 19 19 19 30 27
23 19 19 19 19 19 19 19 19 19 19 19 19 19 31 32 20
22 19 19 19 19 19 19 19 19 19 19 19 19 19 19 19 27
23 19 19 19 19 19 19 19 19 19 19 19 19 19 19 19 20
22 19 19 19 19 19 19 19 19 19 19 19 19 19 19 19 27
23 19 19 19 19 19 19 19 19 19 19 19 19 19 19 19 20
22 19 19 19 19 19 19 19 19 19 19 19 19 19 19 19 27
23 19 19 19 19 19 19 19 19 19 19 19 19 19 19 19 20
22 19 19 19 19 19 19 19 19 19 19 19 19 19 19 19 27
23 19 19 19 19 19 19 19 19 19 19 19 19 19 19 19 20
22 19 19 19 19 19 19 19 19 19 19 19 19 19 19 19 27
23 19 19 19 19 19 19 19 19 19 19 19 19 19 19 19 20
22 19 19 19 19 19 19 19 19 19 19 19 19 19 19 19 27
23 19 19 19 19 19 19 19 19 19 19 19 19 19 19 19 20
22 19 19 19 19 19 19 19 19 19 19 19 19 19 19 19 27
16 13 14 12 13 14 12 13 14 12 13 14 12 13 14 12 17