16 13 14 12 13 14 12 13 14 12 13 14 12 13 14 12 17
23 19 19 19 30 19 19 19 30 19 19 19 19 19 19 19 20
22 19 19 19 33 31 29 19 30 19 29 31 29 19 30 19 27
23 19 29 19 19 19 30 19 33 19 30 19 30 19 30 19 20
22 19 33 31 33 19 30 19 19 19 30 19 19 19 33 31 27
23 19 19 19 30 19 33 31 31 31 32 19 30 19 19 19 20
22 31 19 19 30 19 19 30 19 19 19 19 30 19 30 19 27
23 19 19 31 33 29 31 32 19 29 31 29 32 19 30 19 20
22 19 19 19 19 30 19 19 19 30 19 30 19 19 30 19 27
23 31 31 19 31 32 19 29 31 31 19 32 31 33 32 19 20
22 19 19 19 19 19 19 30 19 19 19 19 19 19 19 19 27
23 19 29 31 31 31 31 32 19 31 31 31 31 31 29 19 20
22 19 30 19 19 19 19 19 19 19 19 19 19 19 30 19 27
23 19 30 19 30 19 29 31 29 19 31 19 30 19 30 19 20
22 19 19 19 30 19 30 19 30 19 19 19 30 19 30 19 27
23 31 29 19 30 19 30 19 33 31 31 19 30 19 30 19 20
22 19 30 19 19 19 30 19 19 19 19 19 30 19 19 19 27
16 13 14 12 13 14 12 13 14 12 13 14 12 13 14 12 17